11111111111
1E1C0P11111
11111111111
11111111111