1111111
10C00E1
1P001C1
1111111