1111111111
100C0C0001
10001E00P1
1111111111