11111111111
100C0P00e01
1E0C000C001
11111111111