1111111111111111
100C0P001e000001
1E0C000C000000e1
1111111111111111