11111111111
100C0P00001
1E0C000C001
11111111111