1111111111111111
100C0P001e000001
1E0C000C00000001
1111111111111111