1111111111111111111111111111111111111111111111111111111111111111111111111111111111111111111111111
1111111111111111111111111111111111111111111111111111111111111111j111111111111Ee0C000000P111111111
1111111111111111111111111111111111111111111111111111111111111111111111111111111111111111111111111