1111111111111111111111111111111111111111111111111111111111111111111111111111111111111111111111111
11111111111111111111111111111111111111111111111111111111111111111111111111111Ee0C000000P111111111
1111111111111111111111111111111111111111111111111111111111111111111111111111111111111111111111111