111111111111111111111111111111111111111111111111111
1111111111111111111111e11e1100E0C0000000P1111111111
111111111111111111111111111111111111111111111111111